バージョン管理ツール	バージョン管理システム
バージョン管理ソフトウェア	バージョン管理システム
継続的インテグレーションシステム	継続的インテグレーションツール
出来	でき
引用文献	参考文献
くわしく	詳しく
与える	あたえる
空隙	スペース
成果物	ドキュメント
体裁	スタイル
pushし	プッシュし
順序あり	順序つき
提要	提供
送付	プッシュ
push	プッシュ
執筆システム	作成システム
チェックツール	検査ツール
ドキュメントの執筆	ドキュメントの作成
ドキュメントを執筆	ドキュメントを作成
ドキュメント執筆	ドキュメント作成
ドキュメントの記述	ドキュメントの作成
ドキュメントを記述	ドキュメントを作成
ドキュメント記述	ドキュメント作成
執筆環境	作成環境
AsciiDoctor	Asciidoctor
精製	生成
レポジトリ	リポジトリ
例えば	たとえば
足り	たり
